<html>
<head><title>poverty</title></head>
<body>
<h1 align="center">EDUCATION IN INDIA : A MAJOR ISSUE</h1>
<img src="edu.jpeg" width = "1700" height = "500" align="middle" border="2">
<font size="5">
<p>1. Economic Growth and Job Creation<p>
Boost Employment: Promote labor-intensive sectors like manufacturing, construction, and services to create more jobs.
Support Entrepreneurship: Provide financial support, training, and market access for small and medium enterprises (SMEs) and startups.
Promote Inclusive Growth: Ensure that economic policies benefit marginalized communities, including Scheduled Castes (SCs), Scheduled Tribes (STs), and women.
<p>2. Focus on Education<p>
Universal Access: Make quality primary, secondary, and higher education accessible to all, particularly in rural and underprivileged areas.
Skill Development: Establish vocational training programs to prepare youth for diverse employment opportunities.
Digital Learning: Expand digital education infrastructure to bridge the urban-rural divide.
<p>3. Improve Healthcare Access<p>
Affordable Healthcare: Expand programs like Ayushman Bharat to ensure medical care for low-income families.
Public Health Infrastructure: Build hospitals and clinics in underserved areas, and improve access to clean water and sanitation.
Nutrition Programs: Scale up programs like ICDS (Integrated Child Development Services) to reduce malnutrition.
<p>4. Strengthen Social Security Systems<p>
Direct Cash Transfers: Expand direct benefit transfer (DBT) schemes to provide financial assistance directly to the needy.
Subsidized Food and Essentials: Strengthen the Public Distribution System (PDS) to ensure food security.
Old Age and Disability Support: Provide pensions and assistance for the elderly, disabled, and other vulnerable groups.
<p>5. Agricultural and Rural Development<p>
Modernize Agriculture: Provide access to technology, irrigation, and credit to increase agricultural productivity.
Allied Activities: Promote dairy farming, fisheries, and agro-based industries to diversify rural income.
Infrastructure Development: Build roads, electrification, and connectivity in rural areas to spur growth.
<p>6. Urban Poverty Alleviation<p>
Affordable Housing: Expand initiatives like the Pradhan Mantri Awas Yojana to provide housing for urban poor.
Skill Training for Urban Migrants: Create employment hubs and skill training programs in urban centers.
Public Transport: Develop affordable and accessible transport systems for urban workers.
<p>7. Women Empowerment<p>
Access to Credit: Encourage microfinance institutions and banks to offer credit to women entrepreneurs.
Education and Skills for Girls: Promote female education and vocational training.
Gender Equality: Ensure equal wages and opportunities for women in the workforce.
<p>8. Leverage Technology and Innovation<p>
Digital Inclusion: Promote internet access and digital literacy in rural and underprivileged areas.
Agri-Tech Solutions: Use technology for better farming practices, market access, and supply chain efficiency.
Smart Subsidies: Use technology to track and distribute subsidies and welfare benefits efficiently.
<p>9. Strengthen Governance and Reduce Corruption<p>
Transparent Systems: Use digital platforms to monitor and implement welfare schemes, ensuring funds reach beneficiaries.
Decentralized Governance: Empower local governments and communities to participate in development initiatives.
Accountability: Increase public awareness and participation to hold officials accountable.
<p>10. Environmental Sustainability<p>
Climate Resilience: Support sustainable farming practices and renewable energy projects.
Disaster Management: Protect vulnerable communities from the impact of natural disasters.
Conservation Efforts: Address issues like deforestation and water scarcity that disproportionately affect the poor.
<p>11. Encourage Public-Private Partnerships (PPPs)<p>
Corporate Social Responsibility (CSR): Encourage businesses to invest in poverty alleviation through CSR.
Private Sector Role: Collaborate with private enterprises to develop infrastructure, education, and health services.
<p>12. Population Control<p>
Awareness Campaigns: Promote family planning and reproductive health education.
Access to Contraceptives: Ensure the availability of affordable contraception.
<p>13. Long-Term Vision and Holistic Approach<p>
Eradicate Inequality: Address systemic issues like caste and gender discrimination.
Community Participation: Involve local communities in planning and implementing development programs.
Monitor Progress: Use data-driven approaches to track poverty reduction and adapt strategies.
</body>
</html>